..............................
..x>..........................
............../1..............
1>1>1>1>1>1>1>1>1>1>1>1v1>1>1>
......2^..............1v......
......2^..............1v......
......2^..............1v......
......2^..............1v......
2<2<2<2^2<2<2<2<2<2<2<2<2<2<2<
..............\2..............
..............................
..............................