META:{"target": 10,"shadow":false}
..u1..........................
..u1..........................
..U1....mv....................
1>1>1>1>1>1>1>1>1>1>1>1>1>1>1>
........M^....................
..............................
......x^......................
..............................
2<2<2<2<2<2<2<2<2<2<2<2<2<2<2<
..............\2..............
..............................
..............................
META:{}
x>....
......
......