...............
.x.............
...............
>>>>>>>>>>>>>>>
...............
...............
...............
...............
<<<<<<<<<<<<<<<
...............
...............
...............