META:{"target": 10,"shadow":false}
..u1..........................
..u1..........................
..u1..........................
1>U11>1>1>1>1>1>1>1>1>1>1>1>1>
..............................
..............................
......x^......................
..............................
2<2<2<2<2<2<2<2<2<2<2<2<2<2<2<
..............\2..............
..............................
..............................
