..............................
..x>..........................
..............................
1>1>1>1>1>1>1>1>1>1>1>2v1>1>1>
......4^..............2v......
......4^..............2v......
......4^..............2v......
......4^..............2v......
3<3<3<4^3<3<3<3<3<3<3<3<3<3<3<
..............................
..............................
..............................